WWWWWWWWWWWWWWW
WDEEEEEEEEEEEEW
WWWWWWWWWWWWWEW
WEEEEEEEEEEEEEW
WEWWWWWWWWWWWEW
WEEEEEEEEEEEEEW
WWWWWWWWWWWWWEW
WEEEEEEEEEEEEEW
WEWWWWWWWWWWWEW
WEEEEEEEEEEEEEW
WWWWWWWWWWWWWEW
WEEEEEEEEEEEEEW
WEWWWWWWWWWWWEW
WEEEEEEEEEEEEAW
WWWWWWWWWWWWWWW