WWWWWWWWWWWWWWW
WDEEEEEEEEEEEEW
WEEEEEEEEEEEEEW
WEEEEEEEEEEEEEW
WEEEEEEEEEEEEEW
WEEEEEEEEEEEEEW
WEEEEEEEEEEEEEW
WEEEEEEEEEEEEEW
WEEEEEEEEEEEEEW
WEEEEEEEEEEEEEW
WEEEEEEEEEEEEEW
WEEEEEEEEEEEEEW
WEEEEEEEEEEEEEW
WEEEEEEEEEEEEAW
WWWWWWWWWWWWWWW