WWWWWWWWWWWWWWW
WDEEEEEEEEEEEEW
WWWWWWWWWWWWWEW
WEEEEEEEEEEEEEW
WEWWWWWWWWWWWWW
WEEEEEEEEEEEEEW
WWWWWWWWWWWWWEW
WEEEEEEEEEEEEEW
WEWWWWWWWWWWWWW
WEEEEEEEEEEEEEW
WWWWWWWWWWWWWEW
WEEEEEEEEEEEEEW
WEWWWWWWWWWWWWW
WEEEEEEEEEEEEAW
WWWWWWWWWWWWWWW